  OVO    OO  OM
 POPOP P P P P 
O         OOOO 
 P PSP P PQPOP 
 M RO O     OO 
 P P P POP POP 
       OO      
 P P PMPOP POP 
    OVOO   O OB