O      O       
 PSP P POP POPM
  OV OR O O   O
OPOP POP P P P 
 O O           
 POP P P P PQP 
O            M 
 P P P P P P P 
B O OMMV     O 