O         M O B
 POPQPOP POPOP 
O          V  O
OP POP POP P P 
M           O  
 POP P P P POP 
 OVOOO O    O  
 P POP P PMP PR
 M     OO     S