B    O V OO   O
 P P P P P P P 
  M  O        O
 POPOP P P P P 
OO  VO M O     
 P POP P P PQP 
ROOMSO      O  
OP P POP POP P 
 O      O  OO  