M    O         
 POPOP P POP P 
 OV O    OM    
OP P P P PRP PO
O  M  OB       
 POP P P P P P 
 Q  OSOO    MO 
OPOPMP P P POPO
O  O   VO  OO  